###################
#00000000E000000E0#
#00###0#000#0###00#
#0##00000#0000E##0#
#00000#######00000#
#0#0#0#0###0#0#0#0#
#00#0000000E000#00#
#00##0#0###0#0##00#
#000000#0#0#0000E0#
#0###@000#00###000#
###B###############