##################
#0#00#00##00#00#0#
#00E00E000E00E000#
#0#0000###00000#0#
#0#00#00000#000#0#
#0#####0#0######0#
#0000000000000000#
#0#00#00@00#00#00#
#000000###0000000#
##################