###################
#00#000#000#000#00#
#0E#0E000#000E0#E0#
#00#0000###0000#00#
#00000#00000#00000#
#0######0#0######0#
#0#0#0#00000#0#0#0#
#0#000000@000000#0#
#0000000###0000000#
#0#0#0#0#B#0#0#0#0#
###################